###################
#				  #
#				  #
#				  #
#			   	  #
#				  #
#				  #
#				  #
#				  #
#				  #
#				  #
#				  #
#				  #
#				  #
#				  #
#				  #
#				  #
#				  #
#				  #
###################